11111111111111111111111111111
14000000000000000000000000041
10111111011111111111011111101
10000041000000000000014000001
10111101011111011111010111101
10000101000000000000010100001
10110101011111011111010101101
10000100000000000000000100001
10110101010111211101010101101
100000010101g333g101010101101
101101010101g333g101010000001
10110101010111111101010101101
10000100000000000000000100001
10110101011111011111010101101
10000101000000p00000010100001
10111101011111011111010111101
10000041000000000000014000001
10111111011111111111011111101
14000000000000000000000000041
11111111111111111111111111111

0 dot
1 wall
2 gate          (only one)
3 blank
4 energizer
p pacman        (only one)
g ghost         (only four)
